21 20
1 1 1 1 1 2 1 1 1 1 1 1 1 1 2 1 1 1 1 1
1 2 2 2 2 2 2 2 2 1 1 2 2 2 2 2 2 2 2 1
1 3 1 1 2 1 1 1 2 1 1 2 1 1 1 2 1 1 3 1
1 2 2 2 2 2 2 2 2 2 2 2 2 2 2 2 2 2 2 1
1 2 1 1 2 1 2 1 1 1 1 1 1 2 1 2 1 1 2 1
1 2 2 2 2 1 2 2 2 1 1 2 2 2 1 2 2 2 2 1
1 1 1 1 2 1 1 1 0 1 1 0 1 1 1 2 1 1 1 1
0 0 0 1 2 1 0 0 0 0 0 0 0 0 1 2 1 0 0 0
1 1 1 1 2 1 0 1 1 0 0 1 1 0 1 2 1 1 1 1
0 0 0 0 2 0 0 1 0 0 0 0 1 0 0 2 0 0 0 0
1 1 1 1 2 1 0 1 1 1 1 1 1 0 1 2 1 1 1 1
0 0 0 1 2 1 0 0 0 0 0 0 0 0 1 2 1 0 0 0
1 1 1 1 2 1 0 1 1 1 1 1 1 0 1 2 1 1 1 1
1 2 2 2 2 2 2 2 2 1 1 2 2 2 2 2 2 2 2 1
1 2 1 1 2 1 1 1 2 1 1 2 1 1 1 2 1 1 2 1
1 3 2 1 2 2 3 2 2 4 2 2 2 2 2 5 1 2 3 1
1 1 2 1 2 1 2 1 1 1 1 1 1 2 1 2 1 2 1 1
1 2 2 2 2 1 2 2 2 1 1 2 2 2 1 2 2 2 2 1
1 2 1 1 1 1 1 1 2 1 1 2 1 1 1 2 1 1 2 1
1 8 7 6 5 8 7 6 5 8 7 6 5 8 7 6 5 7 6 1
1 1 1 1 1 2 1 1 1 1 1 1 1 1 2 1 1 1 1 1